========================================
=> Общие <=
Добавлено автоматическое использование команды .save после вашего лута (повторное использование команды не раньше чем через 22 секунды)
Анонс (для лидера группы) для обновления сложности после ключа (когда все игроки покинут подземелье).
========================================
=> Око азшары <=
Полководец Паржеш - Пронзающее копье - Обратный отсчёт через "say" оставшегося времени дебафа. Удаление метки если каст мелдили/фдшили.
Леди Кольцо Ненависти - Проклятье ведьмы - при накладке со спелом "Кольцо молний" (когда не рекомендуется сдувать тимейтов !!!) обратный отсчёт через /say будет со значком черепа.
Змеикс            - Отравленная рана - Обратный отсчёт через "say" оставшегося времени дебафа
Гнев Азшары       - Морская пучина   - Обратный отсчёт через "say" оставшегося времени дебафа. Удаление метки если каст мелдили/фдшили.
Ходульник Мак'раны - Струя песка - корректировка таймера.
Твердопанцирник Мак'раны - Бронераковина - таймер.
=========================================
=> Чаща Темного Сердца <=
Дубосерд - Сокрушительная хватка - Обратный отсчёт через "say"
=========================================
=> Собор вечной ночи <=
Долбогрыз Глумливый - Глумливый взгляд - Обратный отсчёт через "say" оставшегося времени дебафа
Доматракс - Пылающий архидемон - автометка при появлении моба
=========================================
=> Престол триумвирата <=
Зураал Перерожденный - Мир теней - анонс набора энергии, анонс в чат когда набрано 100% энергии
       		       Сосредоточение внимания - Обратный отсчёт через "say" оставшегося времени дебафа
Открытие ворот к ласту - афк таймер
==========================================
=> Возвращение в Каражан: Нижний ярус
Метёлка - Жесткая уборка - Обратный отсчёт через "say" оставшегося времени дебафа
Благочестивая дева - Священная земля - Обратный отсчёт через "say" оставшегося времени дебафа
Атумен - Разделённые муки - Обратный отсчёт через "say" оставшегося времени
       - Используется транспорт - корректировка таймера
       - анонс на 20% хп
Волшебный страж - Нестабильный заряд - Анонс через /say если на тебе. Обратный отсчёт через "say" оставшегося времени дебафа.
Благоразумный распорядитель, Благонравная горничная - Вой банши - анонс приближающегося каста если у моба меньше 50% хп
Бестелесный распорядитель - Пьяное сокрушение черепа - анонс приближающегося каста если у моба меньше 65% хп
Призрачный помощник смотрителя стойл - Целительное прикосновение - таймер+анонс
==========================================
=> Возвращение в Каражан: Верхний ярус <=
Тень Медива  - Пронзающие стрелы - Отображение таргета каста
             - Инфернальная стрела - Отображение таргета каста
             - Обморожение - Отображение таргета каста
Виз'адуум Всевидящий - Луч скверны - Обратный отсчёт через "say" оставшегося времени дебафа
		     - Флегма тьмы - корректировка таймера.
Король - анонс на 25% хп
	Уязвимость - отключение анонсов/таймеров при уровне здоровья короля 25% и меньше.
	метка/удаление метки {череп} при наложении/снятии уязвимости. 
дверь перед ластом - афк таймер 
==========================================
=> Чертоги Доблести <=
короли (Одновременный запуск нескольких королей больше не требует чатной команды. После нажатия на диалог (лидером группы или помощником) любого короля остальные игроки с этой версией аддона кто находится в выборе диалога другого короля тоже его автоматически нажмут. p.s. чатная команда работает как и раньше (см. тултип в игре в настройках треша в чд).
     Зов предков - таймер+анонс
Кружка меда - анонс при взаимодействии
Хирья       - таймер на активацию босса
	    - фикс очистки таймера на следующее "Освящение" или "Око шторма" в начале боя
            - световое излучение - Обратный отсчёт через "say" оставшегося времени дебафа.
Один        - Корректировка отображения подсказок для "Руническое клеймо". (для танков подсказки будут верные если стоять спиной к трону Одина (как было раньше), а для всех остальных если смотреть лицом на трон)
Фенрир      - Запах крови - Обратный отсчёт через "say" оставшегося времени дебафа.
            - Хищный прыжок - Обратный отсчёт через "say" до начала прыжков. Анонс через /say {череп}  если прыгнул в тебя + звук "Bam".
==========================================
=> Квартал звёзд <=
Подача сигнала      - афк таймер
Отключение маяка    - анонс
Таликса Пламя Гнева - Инфернальное извержение - подсчёт и отображение номера каста по счёту, корректировка таймера.
                      Интенсивное горение - подсчёт и отображение номера каста по счёту, корректировка таймера.
                      Иссохшая душа - подсчёт и отображение номера каста по счёту, корректировка таймера.
Советник Меландр    - Корректировка триггера/таймера на активацию босса
Паладин танк        - Искатель истины - добавлен анонс при обнаружении рядом с его артефактом шпиона (необходимо заранее вытащить артефакт из-за спины)
==========================================
=> Логово нелтариона <=
Злобнозем-исполин    - Трещина - таймер
Рокмора              - Корректировка триггера/таймера на активацию босса.
		     - Дробление - Анонс через сколько появится моб после начала каста (только если появится во время каста !). Если моб появится в первые секунды, то анонс будет оранжевого цвета и звук "Punch". Если в последнюю секунду каста, то анонс красного цвета и звук "Bam" + мигание экрана.
Нараксас             - Шипастый язык - Метка на таргет каста. Анонс через /say если на тебе. Анонс через /say оставшегося времени каста.
Поездка в бочке      - афк таймер
==========================================
=> Крепость чёрной ладьи <=
Слияние душ          - Эхо души - изменён тригер на начало каста (раньше было при наложении дебафа). Добавлен звук если кастуется в тебя. Метка крест на таргет каста. Обратный отсчёт через "say" оставшегося времени дебафа.
		     - Пожирание душ - анонс набраных стаков на боссе
		     - Взрыв души - анонс+вспышка
Открытие ворот       - афк таймер
Иллисанна Гребень Ворона - Пронзающий взгляд - Обратный отсчёт через "say" оставшегося времени дебафа. Метка на таргет каста.
		 	 - Фазы - таймер/анонс
Хмуролоб лютый - Ненавидящий взгляд - Обратный отсчёт через "say" оставшегося времени дебафа. Метка на таргет каста.
	       - Жестокий удар кулаком - анонс для танка и хила когда у босса больше 90% раги. Анонс + звук "Bam" на 100% раги.
	       - Сквернорвота - анонс таргета с дебафом. Анонс через "say" если на тебе.
	       - Призыв сквернотопырей (мобы за решёткой) - таймер.
Латосий - Неумолимый удар (для танков) - отображение номера каста по счёту
	  Залп стрел тьмы - корректировка таймера
	  Жалящий рой - Метка на таргет каста, метка на "Жалящая мошкара"
	  Фаза - анонс
============================================
=> Катакомбы сурамара <=
Корстилакс - Протокол подавления - анонс если на тебе, обратный отсчёт через "say" оставшегося времени дебафа, корректировка таймера наложенного дебафа.
Налтира    - Пожирание (моб) - таймер на первый каст
Советник Вандрос - таймер на активацию босса
                 - Нестабильная мана - обратный отсчёт через "say" оставшегося времени дебафа
		 - Расщепление времени - таймер
	         - Временное ограничение (Вневременный призрак) - анонс таргета с дебафом, обратный отсчёт через "say" оставшегося времени дебафа
Иванир           - Нестабильная магия - обратный отсчёт через "say" оставшегося времени дебафа
Искаженная тень, Волшебная аномалия - Чародейское воссоздание - анонс приближающегося каста если у моба меньше 60% хп
============================================
=> Казематы стражей <=
Кордана Оскверненная Песнь - Корректировка триггера/таймера на активацию босса.
			   - Свет Элуны - анонс через /say при поднятии
			   - Глефа скверны - анонс+таймер
			   - Ползучая погибель - таймер
			   - Аватара отмщения - Корректировка таймера
Тиратон Салтерил           - Корректировка триггера/таймера на активацию босса.
Вул'кан                    - Система безопасности - Корректировка таймера